able=a.有能力的；出色的
abuse=vt.滥用；虐待 n.滥用
accent=n.口音，腔调；重音
add=vt.添加，附加，掺加
alone=a.单独的 ad.单独地
amuse=vt.逗…乐；给…娱乐
camera=n.照相机，摄影机
cell=n.细胞；小房间
cope=vi.对付，应付
cow=n.母牛，奶牛；母兽
dark=a.暗的；黑色的
death=n.死，死亡；灭亡
fact=n.事实；实际，实情
drink=vt.饮 vi.喝 n.饮料
easy=a.容易的；安逸的
farm=n.农场，农庄；饲养场
fear=n.害怕；担心 vt.害怕
fun=n.乐趣，娱乐；玩笑
gain=vt.获得；增加 n.增进
habit=n.习惯；习性
hard=a.硬的；困难的
head=n.头；上端 vt.率领
heavy=a.重的；大的；充满的
human=a.人的，人类的 n.人
image=n.像；形象；映象
inch=n.英寸
layer=n.层，层次；铺设者
lion=n.狮子；勇猛的人
match=n.比赛，竞赛；对手
mercy=n.仁慈，慈悲，恩惠
miss=n.小姐
nod=vt.点(头)；点头表示
nose=n.鼻子；突出部分
organ=n.器官；机构；管风琴
root=n.根，根子 vi.生根
send=vt.送，寄发；派遣
son=n.儿子

