accelerate=vt.(使)加快；促进
beautiful=a.美的，美丽的
breakfast=n.早饭，早餐childhood n.童年，幼年；早期
cigarette=n.香烟，纸烟，卷烟
combination=n.结合，联合；化合
consideration=n.考虑，思考；体贴
effective=a.有效的；有影响的
elevator=n.电梯；升降机
establishment=n.建立，设立，确立
foreigner=n.外国人
friendly=a.友好的，友谊的
gentleman=n.绅士；有教养的人
guarantee=n.保证；担保物
invention=n.发明，创造；捏造
liberation=n.解放
microcomputer=n.微型计算机，微机
necessary=a.必要的；必然的
phenomenon=n.现象
playground=n.操场，运动场
pollution=n.污染
popular=a.民众的；流行的
recognition=n.认出，识别；承认
significance=n.意义，意味；重要性
temperature=n.温度；体温
transformer=n.变压器，转换器
underground=a.地下的；秘密的
wonderful=a.惊人的；极好的
unsatisfactory=a.不能令人满意的
university=n.大学，综合性大学
unbearable=a.难堪的，忍受不了的
transport=vt.运输 n.运输
