abnormal=a.不正常的；变态的
absolute=a.绝对的；纯粹的
abstract=a.抽象的 n.摘要
bottom=n.底，底部，根基
bright=a.明亮的；聪明的
common=a.普通的；共同的
defeat=vt.战胜，击败；挫败
everyday=a.每天的，日常的
exhibit=vt.显示；陈列，展览
expose=vt.使暴露；揭露
flower=n.花，花卉；开花
future=n.将来，未来；前途honest a.诚实的；可敬的
horror=n.恐怖；战栗；憎恶
journey=n.旅行，旅程 n.旅行
kingdom=n.王国；领域，界
lecture=n.&vi.演讲，讲课
majority=n.多数，大多数
mountain=n.山，山岳；山脉
movement=n.动作，活动；移动
nature=n.大自然；本性；性质
nervous=a.神经的；易激动的
permit=vt.允许 n.执照
quality=n.质量；品质，特性
quantity=n.量，数量，分量
reality=n.现实；真实
return=vi.&n.回来，返回
science=n.科学，科学研究
season=n.季，季节，时节
sleepy=a.想睡的；寂静的
southwest=n.西南 a.西南的
workman=n.工人，劳动者，工匠
